#
# 0 D room1.txt 1
# 1 D room1.txt 0 key1
# 2 E room2.txt 0
#
WWWW0WWWWW
W     S  W
W  B  G  W
W   s    W
W        W
W   f  W W
W  h   W W
W      W W
W      W 1
WWWW2WWWWW
